..............###########.###########................
..............#.........#.#.........#................
..............#.......#########.....#................
..............#.......#.#.#...#.....#................
..............#.......#.#.#...#.....#................
..............#.......#.#.#...#.....#................
..............#.#########.#...#.....#................
..............#.#.....#...#...#.....#................
..............#.#.....#...#########.#................
..............#.#.....#.......#...#.#................
..............#########.......#######................
................#.................#..................
................#...........#########................
................#...........#.....#.#................
................#########...#.....#.#................
........................#...#.....#.#................
........................#...#.....#.#................
........................#...#.......#................
........................#...#.......#######..........
........................#...#.............#..........
....................#########.............#..........
....................#...#.................#..........
..................#######.................#..........
..................#.#.....................#..........
..................#.#.....................#..........
..................#.#.....................#..........
..................#.#.....................##########^
..................#.#................................
#######...#########.#................................
#.....#...#.........#................................
#.....#...#.#########................................
#.....#...#.#........................................
#.....#...#.#........................................
#.....#...#.#........................................
#.....#...#.#........................................
#.....#...#.#........................................
#.....#######........................................
#.........#..........................................
###########..........................................

Main:
Function A:
Function B:
Function C:
Continuous video feed?

..............###########.###########................
..............#.........#.#.........#................
..............#.......#########.....#................
..............#.......#.#.#...#.....#................
..............#.......#.#.#...#.....#................
..............#.......#.#.#...#.....#................
..............#.#########.#...#.....#................
..............#.#.....#...#...#.....#................
..............#.#.....#...#########.#................
..............#.#.....#.......#...#.#................
..............#########.......#######................
................#.................#..................
................#...........#########................
................#...........#.....#.#................
................#########...#.....#.#................
........................#...#.....#.#................
........................#...#.....v.#................
........................#...#.......#................
........................#...#.......#######..........
........................#...#.............#..........
....................#########.............#..........
....................#...#.................#..........
..................#######.................#..........
..................#.#.....................#..........
..................#.#.....................#..........
..................#.#.....................#..........
..................#.#.....................###########
..................#.#................................
#######...#########.#................................
#.....#...#.........#................................
#.....#...#.#########................................
#.....#...#.#........................................
#.....#...#.#........................................
#.....#...#.#........................................
#.....#...#.#........................................
#.....#...#.#........................................
#.....#######........................................
#.........#..........................................
###########..........................................

󁁃