! # # # # # ! # # # # # # # # # ! # # # # # # # # # # # # # ! # # # # # # # # # !
#         B #                   #                           #                   #
#   # # # # #   # # # # # # #   #   # # # # # # #   # # #   #   # # # # #   # # !
#                           #       #   #       #       #               #       #
! # # # # # # # # # # # # # #   # # #   #   #   # # #   # # # # # # #   # # #   #
#                   #       #           #   #   #       #           #       #   #
#   # # # # # # #   #   #   # # # # #   #   #   # # # # #   # # #   # # # # #   #
#       #           #   #           #   #   #   #           #   #       #       #
#   #   #   # # # # #   # # # # #   # # #   #   #   # # # # #   # # #   #   #   #
#   #   #               #       #   #       #   #   #   #           #       #   #
#   #   # # # # # # # # #   # # #   #   # # #   #   #   #   # # #   # # # # #   #
#   #   #       #           #       #       #       #       #       #           #
#   #   #   #   # # #   #   #   # # ! # #   # # # # #   # # #   #   #   # # # # !
#   #       #       #   #   #       #       #       #   #       #   #       #   #
#   # # # # # # #   #   #   # # #   #   # # #   #   #   #   #   # # # # #   #   #
#       #           #   #           #       #   #   #   #   #   #       #       #
! # # # #   # # # # #   # # # # # # # # #   #   #   # # #   # # #   #   # # #   #
#           #       #       #               #   #   #       #       #           #
#   # # # # #   #   # # #   #   # # # # # # #   #   #   #   #   # # ! # # # # # !
#       #       #               #       #       #       #   #       #           #
! # #   #   # # # # #   # # # # #   #   # # #   # # # # #   # # #   #   # # #   #
#       #   #       #       #       #     A #   #       #       #   #       #   #
#   # # # # #   #   # # # # #   # # # # # # #   #   #   # # #   #   #   #   #   #
#   #           #               #           #       #   #       #   #   #   #   #
#   #   # # # # # # # # # # # # #   #   # # #   # # #   #   # # #   # # #   # # !
#   #   #                       #   #           #       #       #       #       #
#   #   #   # # # # # # #   # # #   # # # # # # #   # # # # #   # # #   # # #   #
#   #   #               #   #       #   #       #           #       #   #       #
#   #   # # # # #   # # #   #   # # #   #   #   # # #   #   # # #   #   #   #   #
#   #           #   #       #   #       #   #       #   #       #   #       #   #
#   # # # # #   # # #   #   #   # # #   #   # # #   # # # # #   # # # # # # #   #
#       #       #       #   #       #   #       #           #           #       #
! # #   #   # # #   # # # # # # #   #   # # #   # # # # #   # # #   # # #   # # !
#   #       #       #           #   #       #   #       #           #       #   #
#   # # # # #   #   #   # # #   #   # # #   #   #   #   # # # # #   #   # # #   #
#           #   #       #       #       #   #       #       #       #           #
#   # # # # #   # # # # #   # # ! # #   #   # # # # ! # #   #   # # # # # # #   #
#               #       #       #       #           #       #               #   #
#   # # # # # # #   #   # # #   #   # # # # # # #   #   # # # # # # # # # # #   #
#                   #       #                       #                           #
! # # # # # # # # # ! # # # ! # # # # # # # # # # # ! # # # # # # # # # # # # # !